|-----------------------------|
|                             |
|                             |
|                             |
|                             |
|---------------------        |
|                             |
|                             |
|                             |
|                             |
|                             |
|              ---------------|
|                             |
|                             |
|                             |
|                             |
|           #                 |
|    ---------------          |
|                             |
|                             |
|                             |
|                             |
|------         --------------|
|                             |
|                             |
|                   #         |
|                             |
|                             |
|                             |
|                             |
|                             |
|                             |
|                             |
|                             |
|                             |
|                             |
|                             |
|                             |
|                             |
|                             |
|     -------------------     |
|                             |
|                             |
|                             |
|                             |
|                          #  |
|                  -----------|
|                             |
|                             |
|                             |
|-------                      |
|                             |
|                             |
|                             |
|                             |
|       ---------             |
|                             |
|                             |
|                             |
|                             |
|                #            |
|             ---------       |
|                             |
|                             |
|  -------                    |
|                             |
|                             |
|                             |
|                             |
|      0                      |
|                             |
|-----------------------------|